*****XXXX*X*XX*****XXXXX
XX*********XXXXX***XXXXX
XX***XXXXX***XXXX****XXX
XX*****XXXXX*XXXXXX****X
******XXXXXX*********XXX
XX*************XXXXX****